                                      @@@@@@                
          @@@@@@@@@@@@@@@@@@@@             @@@@             
        @@@                   @@@              @@@          
      @@                        @@@@             @@@        
    @@@                            @@@@            @@       
   @@               @@@@@@@           @@@           @@      
  @@             @@@       @@@@@        @@@          @      
  @            @@              @@@        @@         @@     
  @           @                  @@         @         @     
  @          @@                   @         @@        @     
  @          @     1              @@         @@             
 @           @                     @          @       @     
 @           @                     @@         @@      @     
 @                                  @          @      @     
 @                                  @           @      @    
 @@                                  @          @@     @    
  @           @@@@@                  @           @     @    
  @     !     @   @                  @           @     @    
  @          @@                      @            @    @    
  @@        @@@                      @            @    @    
   @       @@ @                      @            @    @    
   @@    @@@                        @@            @    @    
     @@@@@                   @@@@@@@@            @@   @@    
      @@           @@@@@@@@@@@                   @    @     
     @@        @@@@                              @    @     
     @        @@                                @     @     
     @       @@                                @@     @     
     @       @                                 @     @@     
     @       @                               @@      @      
     @       @     *                       @@@       @      
     @       @                           @@@         @      
     @        @@                       @@@          @@      
     @         @@@           @@@@@@@@@@             @       
     @            @@@@@@@@@@@@                     @@       
     @@                                            @        
      @                                           @@        
      @                                          @@         
      @@@                                  @@@@@@@          
        @@@@@@@@@@@@@@                   @@                 
                     @@@@@@@           @@@                  
                            @@@@@@@@@@@@                    
                                                            
                                                            
                                                            
                                                            
                                                            
                                                            
                                                            
                                                            
                                                            
                                                            
                                                            
                                                            
                                                            
                                                            
                                                            
                                                            
                                                            
                                                            
                                                            
