@@@@@@@@@@@@@@@@@@@@@@@@
@.....................@
@.............@.......@
@.............@.......@
@....1........@...!....
@.............@.......@
@.............@.......@
@.....................@
@@@@@@@@@@@@@@@@@@@@@@@@
